EXPECTED_SCORE_P1: 7
EXPECTED_SCORE_P2: 3
........#........
........#........
........#........
......@.#........
..#..#@#..#......
..######.@#..1...
.@#..00##@#..1...
.@#..#00.@#..1...
#################
