EXPECTED_SCORE_P1: 12
EXPECTED_SCORE_P2: 12
..........#..........##..........#..........
@..#..#............#@@@@#............#..#..@
#..#..#.....1...#..######..#...0.....#..#..#
#...........1##..#........#..##0...........#
#...#.....#.1##..............##0.#.....#...#
....####...#####............#####...####....
..#..#.........#....@@@@....#.........#..#..
####0...........#.########.#...........1####
#...0.....##........####........##.....1...#
....0.....#####.....####.....#####.....1....
##..###.@###..#####......#####..###@.###..##
##@.####################################.@##
############################################
