EXPECTED_SCORE_P1: 18
EXPECTED_SCORE_P2: 18
..........#..........##..........#..........
@..#..#............#@@@@#............#..#..@
#..#..#.....1...#..######..#...0.....#..#..#
#...........1##..#........#..##0...........#
#0..#.....#.1##..............##0.#.....#..1#
.0..####..1#####............#####0..####..1.
.0#..#....1....#....@@@@....#....0....#..#1.
####......1.....#1.######.0#.....0......####
#.........##.....1..####..0.....##.........#
..........#####..1..####..0..#####..........
##..###.@###..#####......#####..###@.###..##
##@.####################################.@##
############################################
