EXPECTED_SCORE_P1: 20
EXPECTED_SCORE_P2: 20
#..........................................#
##...................@@...................##
#....................##....................#
@.......#..........................#.......@
........#..........................#........
...........@....................@...........
...........#..1#.##......##.#0..#...........
.##.......#...1#.....@@.....#0...#.......##.
.##..#........1#............#0........#..##.
...#..#....##.#..............#.##....#..#...
..........#..........##..........#..........
@..#..#............#@@@@#............#..#..@
#..#.0#.........#..######..#.........#1.#..#
#....0.......##..#........#..##.......1....#
#...#0....#..##....1....0....##..#....1#...#
....####...#####...1....0...#####...####....
..#..#.........#...1@@@@0...#.........#..#..
####.#0.........#.########.#.........1#.####
#.....0...##........####........##...1.....#
......0...#####.....####.....#####...1......
....###..###......#......#......###..###....
##..###.@###..#####.@@@@.#####..###@.###..##
##@.####################################.@##
############################################
