EXPECTED_SCORE_P1: 15
EXPECTED_SCORE_P2: 15
#..........................................#
##...................@@...................##
#....................##....................#
@.......#..........................#.......@
........#..........................#........
.....0..........................@.....1.....
.....0.....#...#.##......##.#...#.....1.....
.##..0....#....#.....@@.....#....#....1..##.
.##..#.........#............#.........#..##.
...#..#....##.#..............#.##....#..#...
..........#..........##..........#..........
@..#..#............#@@@@#............#..#..@
#..#.0#.........#..######..#.........#1.#..#
#....0.......##..#........#..##.......1....#
#...#0....#..##..............##..#....1#...#
....####...#####............#####...####....
..#..#......0..#....@@@@....#..1......#..#..
####.#......0...#.########.#...1......#.####
#.........##0.......####.......1##.........#
..........#####.....####.....#####..........
....###..###......#......#......###..###....
##..###.@###..#####.@@@@.#####..###@.###..##
##@.####################################.@##
############################################
