EXPECTED_SCORE_P1: 3
EXPECTED_SCORE_P2: 3
###############
#......#......#
#......#......#
#......#......#
#...0..#......#
#..10####.....#
#..10@@....@..#
#..1#.........#
###############
