EXPECTED_SCORE_P1: 3
EXPECTED_SCORE_P2: 4
...............
...............
......@........
...............
.....111.......
.....1.........
.....1..0......
........0..@...
........0......
###############
