EXPECTED_SCORE_P1: 3
EXPECTED_SCORE_P2: 6
...............
...............
...............
.......111.....
.......1.......
....0..@.......
....0.....@....
....0..........
...............
###############
