EXPECTED_SCORE_P1: 7
EXPECTED_SCORE_P2: 6
...............
.1.............
.1.............
.1.........000.
............#..
.1.......@.....
.1.............
.1........000..
###############
