EXPECTED_SCORE_P1: 9
EXPECTED_SCORE_P2: 6
###############
#.........@...#
#.............#
#.............#
#....0....0...#
#11..0....0...#
#11..0....0...#
#11..0....0...#
###############
