EXPECTED_SCORE_P1: 7
EXPECTED_SCORE_P2: 7
#..........................................#
##........................................##
#....................##....................#
........#..........................#........
........#..........................#........
............................................
...........#...#.##......##.#...#...........
.##.......#....#............#....#.......##.
.##..#.........#............#.........#..##.
...#..#....##.#..............#.##....#..#...
..........#..........##..........#..........
...#..#............#....#............#..#...
#..#..#.........#..######..#.........#..#..#
#............##..#........#..##............#
#...#....@#..##..............##..#.....#...#
....####...#####............#####...####....
..#..#......0.0#............#.........#..#..
####.#......0.0.#.########.#..........#@####
#.........##0.0.....####........##.........#
..........#####.....####.....#####..........
....###..###......#......#......###..###11..
##..###..###..#####......#####..###..###11##
##..####################################11##
############################################
