EXPECTED_SCORE_P1: 4
EXPECTED_SCORE_P2: 3
...............
.....@.........
........@......
........#..1...
..0#.......1...
..00...##..1...
...0#......@...
...#@..........
###############

