EXPECTED_SCORE_P1: 4
EXPECTED_SCORE_P2: 3
...............
...............
...............
......0........
..@...0...@....
......0........
......#..#...1.
.............1.
.............1.
###############
