EXPECTED_SCORE_P1: 3
EXPECTED_SCORE_P2: 6
..#..........................................#..
..##........................................##..
..#....................##....................#..
..........#..........................#..........
..........#..........................#..........
................................................
.............#...#.##......##.#...#.............
...##.......#....#............#....#.......##...
...##..#.........#............#.........#..##..0
.....#..#....##.#..............#.##....#..#....0
............#@..0......##..........#...........0
.....#..#...1...0....#....#............#..#.....
..#..#..#1..1...0.#..######..#.........#..#..#..
..#......1..1..##..#........#..##............#..
..#...#..1..#..##..............##..#.....#...#..
......####...#####............#####...####......
....#..#.........#............#.........#..#....
..####.#..........#.########.#..........#.####..
..#.........##........####........##.........#..
............#####.....####.....#####............
......###..###......#......#......###..###......
..##..###..###..#####......#####..###..###..##..
..##..####################################..##..
..############################################..
