EXPECTED_SCORE_P1: 6
EXPECTED_SCORE_P2: 6
#..........................................#
##........................................##
#....................##....................#
@.......#..........................#.......@
........#..........................#........
............................................
...........#...#.##......##.#...#...........
.##.......#....#.....@@.....#....#.......##.
.##..#.........#............#.........#..##.
...#..#....##.#..............#.##....#..#...
..........#..........##..........#..........
...#..#............#....#............#..#...
#..#..#.........#..######..#.........#..#..#
#............##..#........#..##............#
#...#.....#..##..............##..#.....#...#
....####...#####............#####...####....
..#..#......0..#............#..1......#..#..
####.#......0...#.########.#...1......#.####
#.........##0.......####.......1##.........#
..........#####.....####.....#####..........
....###..###......#......#......###..###....
##..###..###..#####......#####..###..###..##
##@.####################################.@##
############################################
