EXPECTED_SCORE_P1: 3
EXPECTED_SCORE_P2: 4
###############
#@............#
#.............#
#.......#.01..#
#.........01..#
#......##.01..#
#.........#1..#
#.........##..#
###############
