EXPECTED_SCORE_P1: 3
EXPECTED_SCORE_P2: 0
###############
#.............#
#.............#
#.............#
#0............#
#0##..........#
#0@.111....#..#
###############
