EXPECTED_SCORE_P1: 5
EXPECTED_SCORE_P2: 3
###############
#.............#
#.............#
#.............#
#............0#
#1...........0#
#1...........0#
#1.....@.....0#
###############
