EXPECTED_SCORE_P1: 0
EXPECTED_SCORE_P2: 3
###############
#....@........#
#.......@.....#
#.......#..1..#
#.......00.1..#
#......##0.1..#
#........0.@..#
#...@.........#
###############
